11111111111111111111111111
100C00000000000C00000C0000000E0001
101001010010000010100100000001010
10100100101010100C1001000000010101
1P0000000C00000000000000C0000000
1111111111111111111111111111111111